11111111111111
10100000000C01
10C01001001001
10011000001001
10001000C01111
1P0000E0000001
11111111111111