11111111111111
10000000000C01
10000000000001
10000000000001
10000000000001
1P0000E0000001
11111111111111