11111111111111
10100000000001
10001001001001
10011000001001
10001000C01111
10000000E0C0P1
11111111111111