11111111111111
10100000000001
10001001001001
10011000001001
10001000001111
1P0C000E000001
11111111111111